elapsed_time,num_reqs,num_reqs_per_sec,min_req_time,max_req_time,avg_req_time,200,302
0,58,2.9,33.736,429.9,129.5473,56,2
20,120,6.0,35.536,238.063,114.6051,86,34
40,258,12.9,34.684,257.038,114.8246,176,82
60,358,17.9,34.318,306.865,107.8439,203,155
80,491,24.55,34.687,1786.523,101.4759,218,273
100,559,27.95,34.57,297.856,100.5702,275,284
120,691,34.55,35.672,325.434,103.528,332,359
140,832,41.6,34.562,297.358,101.0915,386,446
160,880,44.0,33.726,312.176,104.0762,369,511
180,1004,50.2,33.982,356.312,104.3577,390,614
200,1082,54.1,35.745,407.659,110.625,445,637
220,1052,52.6,36.487,381.355,106.4891,395,657
240,1086,54.3,36.06,351.727,109.5985,399,687
260,1149,57.45,35.013,421.824,112.8534,422,727
280,1082,54.1,33.695,571.813,128.3725,416,666
300,1053,52.65,37.402,1300.712,153.7723,370,683
320,1024,51.2,34.683,324.334,100.4425,374,650
340,1089,54.45,33.893,1789.138,111.2145,437,652
360,1069,53.45,33.691,427.855,107.3354,405,664
380,1065,53.25,34.967,383.407,104.4191,394,671
400,1033,51.65,35.812,926.913,115.0799,389,644
420,1135,56.75,38.136,771.318,120.8477,400,735
440,1054,52.7,36.152,408.373,112.1062,403,651
460,1042,52.1,34.345,338.333,102.8802,398,644
480,1133,56.65,34.493,416.699,105.0201,434,699
500,1075,53.75,36.767,288.45,100.0875,402,673
520,1107,55.35,35.41,409.726,110.7483,418,689
540,1107,55.35,36.51,455.693,105.6703,423,684
560,1106,55.3,35.968,364.177,106.1097,406,700
580,1123,56.15,35.193,573.869,107.7819,428,695
600,1134,56.7,36.225,1205.283,108.7651,415,719
620,1128,56.4,36.043,495.55,108.0105,425,703
640,1109,55.45,35.595,1178.541,113.512,448,661
660,1089,54.45,35.098,378.98,108.7274,407,682
680,1140,57.0,33.508,317.56,107.8963,445,695
700,1166,58.3,34.648,519.889,109.8218,477,689
720,1198,59.9,34.866,486.811,118.1184,456,742
740,1299,64.95,35.006,438.881,113.5797,496,803
760,1308,65.4,34.684,1788.611,178.895,494,814
780,1312,65.6,37.95,1766.179,190.7968,499,813
800,1304,65.2,39.231,2620.131,269.1603,521,783
820,1297,64.85,35.31,2214.986,211.9569,477,820
840,1339,66.95,35.964,1966.429,194.1047,503,836
860,1329,66.45,35.349,1660.152,159.9426,499,830
880,1300,65.0,35.365,4061.501,443.0005,495,805
900,1319,65.95,37.729,4236.39,293.3323,457,862
920,1280,64.0,36.242,393.036,106.1011,452,828
940,1213,60.65,36.131,360.636,106.3746,442,771
960,1279,63.95,34.613,439.862,117.2143,457,822
980,1218,60.9,34.751,681.136,118.1802,479,739
1000,1226,61.3,34.744,444.389,120.6507,435,791
1020,1194,59.7,35.51,456.836,115.0816,424,770
1040,1143,57.15,35.274,324.795,106.7776,413,730
1060,1185,59.25,34.423,745.145,116.8984,486,699
1080,1166,58.3,35.407,590.52,131.4052,436,730
1100,1190,59.5,35.099,331.344,109.6014,442,748
1120,1219,60.95,35.76,487.657,125.1904,466,753
1140,1163,58.15,36.186,478.18,112.1627,445,718
1160,1248,62.4,34.896,638.949,128.0415,493,755
1180,1232,61.6,38.75,2521.636,146.5073,457,775
1200,1234,61.7,34.474,2625.423,165.7668,458,776
1220,1226,61.3,33.507,308.944,107.7663,442,784
1240,1216,60.8,36.173,476.043,111.3971,447,769
1260,1228,61.4,36.056,406.847,111.0007,463,765
1280,1234,61.7,38.231,512.298,112.8462,462,772
1300,1065,53.25,36.608,354.13,103.5668,359,706
1320,1103,55.15,35.186,1848.499,180.2648,423,680
1340,1196,59.8,34.704,378.385,113.3496,417,779
1360,1087,54.35,33.944,337.535,108.3018,415,672
1380,1108,55.4,35.436,350.968,108.5228,431,677
1400,1063,53.15,33.696,357.723,107.0029,410,653
1420,1093,54.65,35.923,1156.453,122.4831,407,686
1440,1139,56.95,34.358,552.238,111.422,432,707
1460,1088,54.4,35.072,352.278,104.8744,397,691
1480,1162,58.1,34.276,408.633,112.4722,449,713
1500,1112,55.6,34.216,410.521,105.3057,405,707
1520,1136,56.8,34.553,395.676,100.5178,425,711
1540,1101,55.05,35.302,357.188,105.6348,403,698
1560,1077,53.85,34.389,449.621,104.4632,383,694
1580,1161,58.05,34.638,339.585,107.7367,447,714
1600,1157,57.85,35.48,1809.746,119.8203,443,714
1620,1113,55.65,35.37,377.726,117.6371,434,679
1640,1115,55.75,33.781,440.246,106.9767,424,691
1660,1093,54.65,33.734,398.311,108.1419,383,710
1680,1083,54.15,34.66,530.252,108.7648,441,642
1700,1205,60.25,36.558,364.089,113.7169,476,729
1720,1111,55.55,34.717,429.182,111.0898,406,705
1740,1146,57.3,40.229,318.118,101.8399,381,765
1760,1012,50.6,45.708,256.607,94.0045,311,701
1780,888,44.4,64.931,262.204,88.4803,251,637
1800,783,39.15,63.513,149.661,84.0472,243,540
1820,664,33.2,64.097,164.864,83.0537,216,448
1840,546,27.3,63.027,151.241,83.8777,145,401
1860,447,22.35,64.345,122.193,79.8529,104,343
1880,388,19.4,62.964,119.795,78.5835,78,310
1900,265,13.25,64.275,144.731,75.8856,53,212
1920,163,8.15,64.536,114.649,75.2049,28,135
1940,99,4.95,65.231,92.438,73.5048,12,87
1960,35,1.75,65.986,83.219,72.1217,5,30
1980,8,0.4,69.072,77.853,72.816,,8
2000,5,0.25,72.484,81.44,77.3592,1,4
